2 7
2 0 0 1 1 0 0
1 1 0 1 1 1 1
1 1 0 0 0 0 0
0 1 0 1 1 1 0
1 1 1 1 0 0 0
0 0 0 1 1 1 1
0 0 0 1 0 0 3

2 7
1 1 0 0 0 1 0
1 1 1 1 0 1 0
0 0 0 0 0 1 0
1 1 1 1 1 1 1
0 0 0 1 0 0 1
2 0 0 1 0 0 3
0 0 0 0 0 0 0

2 7
2 0 1 0 0 1 0
1 1 1 1 1 1 1
1 0 0 0 0 0 1
1 1 1 1 1 0 1
0 0 0 0 1 0 1
1 1 0 1 1 0 1
0 0 0 1 0 0 3

2 7
2 0 0 0 1 0 0
1 1 1 1 1 1 0
1 0 0 0 0 1 1
1 1 0 1 1 1 1
0 1 0 0 0 1 1
0 1 1 1 1 1 0
0 0 0 1 0 1 3

2 7
2 0 0 0 1 0 1
1 1 0 1 1 1 1
1 0 0 0 0 1 1
1 1 1 1 1 0 0
0 0 0 0 1 1 1
0 1 1 1 1 1 0
0 0 0 1 0 1 3