*** LABIRINTO ***
>> Estado: 0
2 0 0 0 1 0 0 0 0 0 
1 0 0 0 1 0 0 0 0 0 
1 0 0 0 1 0 0 0 0 0 
1 1 1 1 1 1 1 1 1 1 
0 0 0 1 0 1 0 1 0 0 
0 0 0 1 0 1 0 1 0 0 
0 0 1 1 1 1 0 1 0 0 
0 0 1 0 0 0 0 1 0 0 
0 0 1 0 0 0 0 1 0 0 
0 0 1 3 1 1 1 1 0 0 

>> Estado: 1
1 0 0 0 1 0 0 0 0 0 
2 0 0 0 1 0 0 0 0 0 
1 0 0 0 1 0 0 0 0 0 
1 1 1 1 1 1 1 1 1 1 
0 0 0 1 0 1 0 1 0 0 
0 0 0 1 0 1 0 1 0 0 
0 0 1 1 1 1 0 1 0 0 
0 0 1 0 0 0 0 1 0 0 
0 0 1 0 0 0 0 1 0 0 
0 0 1 3 1 1 1 1 0 0 

>> Estado: 2
1 0 0 0 1 0 0 0 0 0 
1 0 0 0 1 0 0 0 0 0 
2 0 0 0 1 0 0 0 0 0 
1 1 1 1 1 1 1 1 1 1 
0 0 0 1 0 1 0 1 0 0 
0 0 0 1 0 1 0 1 0 0 
0 0 1 1 1 1 0 1 0 0 
0 0 1 0 0 0 0 1 0 0 
0 0 1 0 0 0 0 1 0 0 
0 0 1 3 1 1 1 1 0 0 

>> Estado: 3
1 0 0 0 1 0 0 0 0 0 
1 0 0 0 1 0 0 0 0 0 
1 0 0 0 1 0 0 0 0 0 
2 1 1 1 1 1 1 1 1 1 
0 0 0 1 0 1 0 1 0 0 
0 0 0 1 0 1 0 1 0 0 
0 0 1 1 1 1 0 1 0 0 
0 0 1 0 0 0 0 1 0 0 
0 0 1 0 0 0 0 1 0 0 
0 0 1 3 1 1 1 1 0 0 

>> Estado: 4
1 0 0 0 1 0 0 0 0 0 
1 0 0 0 1 0 0 0 0 0 
1 0 0 0 1 0 0 0 0 0 
1 2 1 1 1 1 1 1 1 1 
0 0 0 1 0 1 0 1 0 0 
0 0 0 1 0 1 0 1 0 0 
0 0 1 1 1 1 0 1 0 0 
0 0 1 0 0 0 0 1 0 0 
0 0 1 0 0 0 0 1 0 0 
0 0 1 3 1 1 1 1 0 0 

>> Estado: 5
1 0 0 0 1 0 0 0 0 0 
1 0 0 0 1 0 0 0 0 0 
1 0 0 0 1 0 0 0 0 0 
1 1 2 1 1 1 1 1 1 1 
0 0 0 1 0 1 0 1 0 0 
0 0 0 1 0 1 0 1 0 0 
0 0 1 1 1 1 0 1 0 0 
0 0 1 0 0 0 0 1 0 0 
0 0 1 0 0 0 0 1 0 0 
0 0 1 3 1 1 1 1 0 0 

>> Estado: 6
1 0 0 0 1 0 0 0 0 0 
1 0 0 0 1 0 0 0 0 0 
1 0 0 0 1 0 0 0 0 0 
1 1 1 2 1 1 1 1 1 1 
0 0 0 1 0 1 0 1 0 0 
0 0 0 1 0 1 0 1 0 0 
0 0 1 1 1 1 0 1 0 0 
0 0 1 0 0 0 0 1 0 0 
0 0 1 0 0 0 0 1 0 0 
0 0 1 3 1 1 1 1 0 0 

>> Estado: 7
1 0 0 0 1 0 0 0 0 0 
1 0 0 0 1 0 0 0 0 0 
1 0 0 0 1 0 0 0 0 0 
1 1 1 1 1 1 1 1 1 1 
0 0 0 2 0 1 0 1 0 0 
0 0 0 1 0 1 0 1 0 0 
0 0 1 1 1 1 0 1 0 0 
0 0 1 0 0 0 0 1 0 0 
0 0 1 0 0 0 0 1 0 0 
0 0 1 3 1 1 1 1 0 0 

>> Estado: 8
1 0 0 0 1 0 0 0 0 0 
1 0 0 0 1 0 0 0 0 0 
1 0 0 0 1 0 0 0 0 0 
1 1 1 1 2 1 1 1 1 1 
0 0 0 1 0 1 0 1 0 0 
0 0 0 1 0 1 0 1 0 0 
0 0 1 1 1 1 0 1 0 0 
0 0 1 0 0 0 0 1 0 0 
0 0 1 0 0 0 0 1 0 0 
0 0 1 3 1 1 1 1 0 0 

>> Estado: 9
1 0 0 0 1 0 0 0 0 0 
1 0 0 0 1 0 0 0 0 0 
1 0 0 0 1 0 0 0 0 0 
1 1 1 1 1 1 1 1 1 1 
0 0 0 1 0 1 0 1 0 0 
0 0 0 2 0 1 0 1 0 0 
0 0 1 1 1 1 0 1 0 0 
0 0 1 0 0 0 0 1 0 0 
0 0 1 0 0 0 0 1 0 0 
0 0 1 3 1 1 1 1 0 0 

>> Estado: 10
1 0 0 0 1 0 0 0 0 0 
1 0 0 0 1 0 0 0 0 0 
1 0 0 0 2 0 0 0 0 0 
1 1 1 1 1 1 1 1 1 1 
0 0 0 1 0 1 0 1 0 0 
0 0 0 1 0 1 0 1 0 0 
0 0 1 1 1 1 0 1 0 0 
0 0 1 0 0 0 0 1 0 0 
0 0 1 0 0 0 0 1 0 0 
0 0 1 3 1 1 1 1 0 0 

>> Estado: 11
1 0 0 0 1 0 0 0 0 0 
1 0 0 0 1 0 0 0 0 0 
1 0 0 0 1 0 0 0 0 0 
1 1 1 1 1 2 1 1 1 1 
0 0 0 1 0 1 0 1 0 0 
0 0 0 1 0 1 0 1 0 0 
0 0 1 1 1 1 0 1 0 0 
0 0 1 0 0 0 0 1 0 0 
0 0 1 0 0 0 0 1 0 0 
0 0 1 3 1 1 1 1 0 0 

>> Estado: 12
1 0 0 0 1 0 0 0 0 0 
1 0 0 0 1 0 0 0 0 0 
1 0 0 0 1 0 0 0 0 0 
1 1 1 1 1 1 1 1 1 1 
0 0 0 1 0 1 0 1 0 0 
0 0 0 1 0 1 0 1 0 0 
0 0 1 2 1 1 0 1 0 0 
0 0 1 0 0 0 0 1 0 0 
0 0 1 0 0 0 0 1 0 0 
0 0 1 3 1 1 1 1 0 0 

>> Estado: 13
1 0 0 0 1 0 0 0 0 0 
1 0 0 0 2 0 0 0 0 0 
1 0 0 0 1 0 0 0 0 0 
1 1 1 1 1 1 1 1 1 1 
0 0 0 1 0 1 0 1 0 0 
0 0 0 1 0 1 0 1 0 0 
0 0 1 1 1 1 0 1 0 0 
0 0 1 0 0 0 0 1 0 0 
0 0 1 0 0 0 0 1 0 0 
0 0 1 3 1 1 1 1 0 0 

>> Estado: 14
1 0 0 0 1 0 0 0 0 0 
1 0 0 0 1 0 0 0 0 0 
1 0 0 0 1 0 0 0 0 0 
1 1 1 1 1 1 1 1 1 1 
0 0 0 1 0 2 0 1 0 0 
0 0 0 1 0 1 0 1 0 0 
0 0 1 1 1 1 0 1 0 0 
0 0 1 0 0 0 0 1 0 0 
0 0 1 0 0 0 0 1 0 0 
0 0 1 3 1 1 1 1 0 0 

>> Estado: 15
1 0 0 0 1 0 0 0 0 0 
1 0 0 0 1 0 0 0 0 0 
1 0 0 0 1 0 0 0 0 0 
1 1 1 1 1 1 2 1 1 1 
0 0 0 1 0 1 0 1 0 0 
0 0 0 1 0 1 0 1 0 0 
0 0 1 1 1 1 0 1 0 0 
0 0 1 0 0 0 0 1 0 0 
0 0 1 0 0 0 0 1 0 0 
0 0 1 3 1 1 1 1 0 0 

>> Estado: 16
1 0 0 0 1 0 0 0 0 0 
1 0 0 0 1 0 0 0 0 0 
1 0 0 0 1 0 0 0 0 0 
1 1 1 1 1 1 1 1 1 1 
0 0 0 1 0 1 0 1 0 0 
0 0 0 1 0 1 0 1 0 0 
0 0 2 1 1 1 0 1 0 0 
0 0 1 0 0 0 0 1 0 0 
0 0 1 0 0 0 0 1 0 0 
0 0 1 3 1 1 1 1 0 0 

>> Estado: 17
1 0 0 0 1 0 0 0 0 0 
1 0 0 0 1 0 0 0 0 0 
1 0 0 0 1 0 0 0 0 0 
1 1 1 1 1 1 1 1 1 1 
0 0 0 1 0 1 0 1 0 0 
0 0 0 1 0 1 0 1 0 0 
0 0 1 1 2 1 0 1 0 0 
0 0 1 0 0 0 0 1 0 0 
0 0 1 0 0 0 0 1 0 0 
0 0 1 3 1 1 1 1 0 0 

>> Estado: 18
1 0 0 0 2 0 0 0 0 0 
1 0 0 0 1 0 0 0 0 0 
1 0 0 0 1 0 0 0 0 0 
1 1 1 1 1 1 1 1 1 1 
0 0 0 1 0 1 0 1 0 0 
0 0 0 1 0 1 0 1 0 0 
0 0 1 1 1 1 0 1 0 0 
0 0 1 0 0 0 0 1 0 0 
0 0 1 0 0 0 0 1 0 0 
0 0 1 3 1 1 1 1 0 0 

>> Estado: 19
1 0 0 0 1 0 0 0 0 0 
1 0 0 0 1 0 0 0 0 0 
1 0 0 0 1 0 0 0 0 0 
1 1 1 1 1 1 1 1 1 1 
0 0 0 1 0 1 0 1 0 0 
0 0 0 1 0 2 0 1 0 0 
0 0 1 1 1 1 0 1 0 0 
0 0 1 0 0 0 0 1 0 0 
0 0 1 0 0 0 0 1 0 0 
0 0 1 3 1 1 1 1 0 0 

>> Estado: 20
1 0 0 0 1 0 0 0 0 0 
1 0 0 0 1 0 0 0 0 0 
1 0 0 0 1 0 0 0 0 0 
1 1 1 1 1 1 1 2 1 1 
0 0 0 1 0 1 0 1 0 0 
0 0 0 1 0 1 0 1 0 0 
0 0 1 1 1 1 0 1 0 0 
0 0 1 0 0 0 0 1 0 0 
0 0 1 0 0 0 0 1 0 0 
0 0 1 3 1 1 1 1 0 0 

>> Estado: 21
1 0 0 0 1 0 0 0 0 0 
1 0 0 0 1 0 0 0 0 0 
1 0 0 0 1 0 0 0 0 0 
1 1 1 1 1 1 1 1 1 1 
0 0 0 1 0 1 0 1 0 0 
0 0 0 1 0 1 0 1 0 0 
0 0 1 1 1 1 0 1 0 0 
0 0 2 0 0 0 0 1 0 0 
0 0 1 0 0 0 0 1 0 0 
0 0 1 3 1 1 1 1 0 0 

>> Estado: 22
1 0 0 0 1 0 0 0 0 0 
1 0 0 0 1 0 0 0 0 0 
1 0 0 0 1 0 0 0 0 0 
1 1 1 1 1 1 1 1 1 1 
0 0 0 1 0 1 0 1 0 0 
0 0 0 1 0 1 0 1 0 0 
0 0 1 1 1 2 0 1 0 0 
0 0 1 0 0 0 0 1 0 0 
0 0 1 0 0 0 0 1 0 0 
0 0 1 3 1 1 1 1 0 0 

>> Estado: 23
1 0 0 0 1 0 0 0 0 0 
1 0 0 0 1 0 0 0 0 0 
1 0 0 0 1 0 0 0 0 0 
1 1 1 1 1 1 1 1 1 1 
0 0 0 1 0 1 0 2 0 0 
0 0 0 1 0 1 0 1 0 0 
0 0 1 1 1 1 0 1 0 0 
0 0 1 0 0 0 0 1 0 0 
0 0 1 0 0 0 0 1 0 0 
0 0 1 3 1 1 1 1 0 0 

>> Estado: 24
1 0 0 0 1 0 0 0 0 0 
1 0 0 0 1 0 0 0 0 0 
1 0 0 0 1 0 0 0 0 0 
1 1 1 1 1 1 1 1 2 1 
0 0 0 1 0 1 0 1 0 0 
0 0 0 1 0 1 0 1 0 0 
0 0 1 1 1 1 0 1 0 0 
0 0 1 0 0 0 0 1 0 0 
0 0 1 0 0 0 0 1 0 0 
0 0 1 3 1 1 1 1 0 0 

>> Estado: 25
1 0 0 0 1 0 0 0 0 0 
1 0 0 0 1 0 0 0 0 0 
1 0 0 0 1 0 0 0 0 0 
1 1 1 1 1 1 1 1 1 1 
0 0 0 1 0 1 0 1 0 0 
0 0 0 1 0 1 0 1 0 0 
0 0 1 1 1 1 0 1 0 0 
0 0 1 0 0 0 0 1 0 0 
0 0 2 0 0 0 0 1 0 0 
0 0 1 3 1 1 1 1 0 0 

>> Estado: 26
1 0 0 0 1 0 0 0 0 0 
1 0 0 0 1 0 0 0 0 0 
1 0 0 0 1 0 0 0 0 0 
1 1 1 1 1 1 1 1 1 1 
0 0 0 1 0 1 0 1 0 0 
0 0 0 1 0 1 0 2 0 0 
0 0 1 1 1 1 0 1 0 0 
0 0 1 0 0 0 0 1 0 0 
0 0 1 0 0 0 0 1 0 0 
0 0 1 3 1 1 1 1 0 0 

>> Estado: 27
1 0 0 0 1 0 0 0 0 0 
1 0 0 0 1 0 0 0 0 0 
1 0 0 0 1 0 0 0 0 0 
1 1 1 1 1 1 1 1 1 2 
0 0 0 1 0 1 0 1 0 0 
0 0 0 1 0 1 0 1 0 0 
0 0 1 1 1 1 0 1 0 0 
0 0 1 0 0 0 0 1 0 0 
0 0 1 0 0 0 0 1 0 0 
0 0 1 3 1 1 1 1 0 0 

>> Estado: 28
1 0 0 0 1 0 0 0 0 0 
1 0 0 0 1 0 0 0 0 0 
1 0 0 0 1 0 0 0 0 0 
1 1 1 1 1 1 1 1 1 1 
0 0 0 1 0 1 0 1 0 0 
0 0 0 1 0 1 0 1 0 0 
0 0 1 1 1 1 0 1 0 0 
0 0 1 0 0 0 0 1 0 0 
0 0 1 0 0 0 0 1 0 0 
0 0 2 3 1 1 1 1 0 0 

>> Estado: 29
1 0 0 0 1 0 0 0 0 0 
1 0 0 0 1 0 0 0 0 0 
1 0 0 0 1 0 0 0 0 0 
1 1 1 1 1 1 1 1 1 1 
0 0 0 1 0 1 0 1 0 0 
0 0 0 1 0 1 0 1 0 0 
0 0 1 1 1 1 0 2 0 0 
0 0 1 0 0 0 0 1 0 0 
0 0 1 0 0 0 0 1 0 0 
0 0 1 3 1 1 1 1 0 0 

>> Estado: 30
1 0 0 0 1 0 0 0 0 0 
1 0 0 0 1 0 0 0 0 0 
1 0 0 0 1 0 0 0 0 0 
1 1 1 1 1 1 1 1 1 1 
0 0 0 1 0 1 0 1 0 0 
0 0 0 1 0 1 0 1 0 0 
0 0 1 1 1 1 0 1 0 0 
0 0 1 0 0 0 0 1 0 0 
0 0 1 0 0 0 0 1 0 0 
0 0 3 2 1 1 1 1 0 0 

>> Encontrei!
>> Profundidade da meta: 14
Total de nos: 31
