*** LABIRINTO ***
>> Estado: 0
2 0 0 0 1 0 
1 0 0 0 1 0 
1 0 0 0 1 0 
1 1 1 1 1 1 
0 0 0 1 0 1 
0 0 0 1 0 3 

>> Estado: 1
1 0 0 0 1 0 
2 0 0 0 1 0 
1 0 0 0 1 0 
1 1 1 1 1 1 
0 0 0 1 0 1 
0 0 0 1 0 3 

>> Estado: 2
1 0 0 0 1 0 
1 0 0 0 1 0 
2 0 0 0 1 0 
1 1 1 1 1 1 
0 0 0 1 0 1 
0 0 0 1 0 3 

>> Estado: 3
1 0 0 0 1 0 
1 0 0 0 1 0 
1 0 0 0 1 0 
2 1 1 1 1 1 
0 0 0 1 0 1 
0 0 0 1 0 3 

>> Estado: 4
1 0 0 0 1 0 
1 0 0 0 1 0 
1 0 0 0 1 0 
1 2 1 1 1 1 
0 0 0 1 0 1 
0 0 0 1 0 3 

>> Estado: 5
1 0 0 0 1 0 
1 0 0 0 1 0 
1 0 0 0 1 0 
1 1 2 1 1 1 
0 0 0 1 0 1 
0 0 0 1 0 3 

>> Estado: 6
1 0 0 0 1 0 
1 0 0 0 1 0 
1 0 0 0 1 0 
1 1 1 2 1 1 
0 0 0 1 0 1 
0 0 0 1 0 3 

>> Estado: 7
1 0 0 0 1 0 
1 0 0 0 1 0 
1 0 0 0 1 0 
1 1 1 1 1 1 
0 0 0 2 0 1 
0 0 0 1 0 3 

>> Estado: 8
1 0 0 0 1 0 
1 0 0 0 1 0 
1 0 0 0 1 0 
1 1 1 1 2 1 
0 0 0 1 0 1 
0 0 0 1 0 3 

>> Estado: 9
1 0 0 0 1 0 
1 0 0 0 1 0 
1 0 0 0 1 0 
1 1 1 1 1 1 
0 0 0 1 0 1 
0 0 0 2 0 3 

>> Estado: 10
1 0 0 0 1 0 
1 0 0 0 1 0 
1 0 0 0 2 0 
1 1 1 1 1 1 
0 0 0 1 0 1 
0 0 0 1 0 3 

>> Estado: 11
1 0 0 0 1 0 
1 0 0 0 1 0 
1 0 0 0 1 0 
1 1 1 1 1 2 
0 0 0 1 0 1 
0 0 0 1 0 3 

>> Estado: 12
1 0 0 0 1 0 
1 0 0 0 2 0 
1 0 0 0 1 0 
1 1 1 1 1 1 
0 0 0 1 0 1 
0 0 0 1 0 3 

>> Estado: 13
1 0 0 0 1 0 
1 0 0 0 1 0 
1 0 0 0 1 0 
1 1 1 1 1 1 
0 0 0 1 0 2 
0 0 0 1 0 3 

>> Estado: 14
1 0 0 0 2 0 
1 0 0 0 1 0 
1 0 0 0 1 0 
1 1 1 1 1 1 
0 0 0 1 0 1 
0 0 0 1 0 3 

>> Estado: 15
1 0 0 0 1 0 
1 0 0 0 1 0 
1 0 0 0 1 0 
1 1 1 1 1 1 
0 0 0 1 0 3 
0 0 0 1 0 2 

>> Encontrei!
>> Profundidade da meta: 10
Total de nos: 16
