*** LABIRINTO ***
>> Estado: 0
2 0 0 0 1 0 
1 0 0 0 1 0 
1 0 0 0 0 0 
1 1 1 1 0 1 
0 0 0 1 0 1 
0 0 0 1 0 3 

>> Estado: 1
1 0 0 0 1 0 
2 0 0 0 1 0 
1 0 0 0 0 0 
1 1 1 1 0 1 
0 0 0 1 0 1 
0 0 0 1 0 3 

>> Estado: 2
1 0 0 0 1 0 
1 0 0 0 1 0 
2 0 0 0 0 0 
1 1 1 1 0 1 
0 0 0 1 0 1 
0 0 0 1 0 3 

>> Estado: 3
1 0 0 0 1 0 
1 0 0 0 1 0 
1 0 0 0 0 0 
2 1 1 1 0 1 
0 0 0 1 0 1 
0 0 0 1 0 3 

>> Estado: 4
1 0 0 0 1 0 
1 0 0 0 1 0 
1 0 0 0 0 0 
1 2 1 1 0 1 
0 0 0 1 0 1 
0 0 0 1 0 3 

>> Estado: 5
1 0 0 0 1 0 
1 0 0 0 1 0 
1 0 0 0 0 0 
1 1 2 1 0 1 
0 0 0 1 0 1 
0 0 0 1 0 3 

>> Estado: 6
1 0 0 0 1 0 
1 0 0 0 1 0 
1 0 0 0 0 0 
1 1 1 2 0 1 
0 0 0 1 0 1 
0 0 0 1 0 3 

>> Estado: 7
1 0 0 0 1 0 
1 0 0 0 1 0 
1 0 0 0 0 0 
1 1 1 1 0 1 
0 0 0 2 0 1 
0 0 0 1 0 3 

>> Estado: 8
1 0 0 0 1 0 
1 0 0 0 1 0 
1 0 0 0 0 0 
1 1 1 1 0 1 
0 0 0 1 0 1 
0 0 0 2 0 3 

>> Nao encontrei!
Total de nos: 9
